11111111111111111111111111111
1E0000000000000C0000000000001
10100101001000001000000010101
10100100101010100010000010101
1P0000000C00C00000000000000C1
10000000000000000000000000001
10100101001000001010000010101
1C100101001000001010010000101
11111111111111111111111111111
