1111111111
1P1CE00001
100010C001
1010101101
1111111111
