1111111111
1P10E01001
1000101001
1C10001101
1111111111
